21 21 21 21 27 21 21 21 21 21 27 21 21 21 21 21 27 21 21 21 21 21 21 21 21 21
21 05 05 05 05 05 05 05 05 05 05 05 05 05 05 05 05 05 05 05 05 05 05 05 21 21
21 05 05 05 05 05 05 05 05 05 05 05 05 05 05 05 05 05 05 05 05 05 05 05 21 21
21 05 05 05 05 05 05 05 05 05 05 05 05 17 05 05 05 05 17 05 05 21 05 05 29 21
21 05 05 05 05 05 05 05 05 05 05 05 05 05 05 05 05 05 05 05 05 21 05 05 21 21
21 05 05 05 05 05 05 05 05 05 05 05 05 05 05 05 05 05 05 05 05 21 05 05 21 21
21 05 05 17 05 05 05 05 17 05 05 05 05 17 05 05 05 05 17 05 05 21 05 05 21 21
21 05 05 05 05 05 05 05 05 05 05 05 05 05 05 05 05 05 05 05 05 21 05 05 21 21
21 05 05 05 05 05 05 05 05 05 05 05 05 05 05 05 05 05 05 05 05 21 05 05 21 21
21 21 21 21 27 21 21 21 21 21 27 21 21 21 21 21 27 21 21 21 21 21 05 05 29 21
21 05 05 05 05 05 05 05 05 05 05 05 05 05 05 05 05 05 05 05 05 05 05 05 21 21
21 05 05 05 05 05 05 05 05 05 05 05 05 05 05 05 05 05 05 05 05 05 05 05 21 21
21 21 21 21 21 21 21 21 21 21 21 05 05 05 21 21 21 21 21 21 21 21 21 21 21 21
21 21 21 21 21 21 21 21 21 21 21 05 06 05 21 21 21 21 21 21 21 21 21 21 21 21
21 21 21 21 21 21 21 21 21 21 21 05 05 05 21 21 21 21 21 21 21 21 21 21 21 21