21 21 21 21 21 21 27 21 21 21 27 21 21 21 21 21 27 21 21 21 21 21 21 21 21 21
05 05 05 21 05 05 05 05 05 21 05 05 05 05 05 05 05 05 05 05 05 05 05 05 21 21
05 05 05 21 05 05 05 05 05 21 05 05 05 05 05 05 05 05 05 05 05 05 05 05 21 21
05 05 05 21 05 05 21 05 05 21 05 05 05 05 05 05 05 05 05 05 05 27 05 05 29 21
27 05 05 21 05 05 21 05 05 21 05 05 05 05 05 05 05 05 05 05 05 21 05 05 21 21
21 05 05 21 05 05 21 05 05 21 05 05 05 05 05 05 05 05 05 05 05 21 05 05 21 21
21 05 05 21 05 05 21 05 05 27 21 21 21 21 21 21 21 21 21 05 05 21 05 05 21 21
21 05 05 05 05 05 21 05 05 05 05 05 05 05 05 05 05 05 05 05 05 21 05 05 21 21
21 05 05 05 05 05 21 05 05 05 05 05 05 05 05 05 05 05 05 05 05 21 05 05 21 21
21 21 21 27 21 21 21 21 21 21 27 21 21 21 21 21 27 21 21 21 21 21 05 05 29 21
21 05 05 05 05 05 05 05 05 05 05 05 05 05 05 05 05 05 05 05 05 05 05 05 21 21
21 05 05 05 05 05 05 05 05 05 05 05 05 05 05 05 05 05 05 05 05 05 05 05 21 21
21 05 05 05 21 21 21 21 21 21 21 05 05 05 21 21 21 21 21 21 21 21 21 21 21 21
21 05 05 05 21 21 21 21 21 21 21 05 05 05 21 21 21 21 21 21 21 21 21 21 21 21
21 21 21 21 21 21 21 21 21 21 21 21 21 21 21 21 21 21 21 21 21 21 21 21 21 21