23 23 23 23 23 23 23 23 23 23 23 23 23 23 23 23 23 23 23 23 23 21 21 21 21 23 23 23 23 23 23 23 23 23 23 23 23 23 23 23 23 23 23 23 23 23 23 23 23 23 
23 15 15 15 15 15 15 20 20 20 20 20 20 20 20 20 20 20 15 15 21 21 25 25 21 21 15 15 20 20 20 20 20 20 20 20 20 20 20 15 15 20 15 15 20 15 20 15 15 23 
23 15 15 15 15 15 20 20 20 20 20 20 20 20 20 20 20 20 14 21 21 21 22 22 21 21 21 14 20 20 20 20 20 20 20 20 20 20 20 15 15 15 15 15 15 15 20 15 20 23 
23 15 15 15 15 20 20 20 20 20 20 20 20 20 20 20 20 20 14 21 27 22 22 22 22 29 21 14 20 20 20 20 20 20 20 20 20 20 20 20 15 15 15 15 15 20 15 15 15 23 
23 15 15 15 20 20 20 20 20 20 20 20 20 20 20 20 20 20 14 21 22 22 22 22 22 22 21 14 20 20 20 20 20 18 20 20 20 20 20 20 20 20 15 20 20 20 20 20 20 23 
23 15 15 20 20 20 20 20 20 20 20 14 20 20 20 20 20 20 14 21 22 22 22 22 22 22 21 14 20 20 14 20 20 20 20 20 20 20 20 20 20 15 15 20 20 20 20 20 15 23
23 15 20 20 20 20 20 20 20 20 20 20 20 20 20 20 20 20 14 21 22 22 22 22 22 22 21 14 20 20 20 20 20 20 20 20 20 14 20 20 20 20 20 20 20 20 20 20 15 23 
23 20 20 20 20 20 20 20 20 20 20 20 20 20 20 20 20 20 14 14 20 20 24 24 20 20 14 14 20 20 20 20 20 20 20 20 20 20 20 20 20 20 20 20 20 20 15 15 15 23
23 20 20 20 20 20 14 20 20 20 20 20 20 20 20 20 20 20 20 20 20 20 24 24 20 20 20 20 20 20 20 20 20 20 20 20 20 20 20 20 20 18 20 20 20 20 20 15 15 23 
23 20 20 20 20 20 20 20 20 20 20 20 18 20 14 20 20 20 20 20 20 20 24 20 20 20 20 20 20 20 20 20 20 20 20 18 20 20 20 20 20 20 20 20 20 15 20 15 15 23
23 20 20 20 18 20 20 20 20 20 20 20 20 20 20 20 20 20 20 20 20 20 24 24 20 20 20 20 20 20 20 20 20 20 20 20 20 20 20 20 20 20 20 20 20 15 20 20 15 23 
23 20 20 20 20 20 20 20 20 20 20 20 20 20 20 20 20 20 20 20 20 20 24 24 20 20 14 20 20 20 18 20 20 20 20 20 20 20 20 20 20 20 20 18 20 20 15 20 20 23
23 20 20 20 20 20 20 20 20 20 20 20 20 20 20 20 14 20 20 20 18 20 24 24 20 20 20 20 20 20 20 20 20 20 14 14 14 20 20 14 20 20 20 20 20 20 20 20 20 23
23 15 20 20 20 20 20 20 20 18 20 20 20 20 20 20 20 20 20 20 20 20 24 24 20 20 20 20 20 20 20 20 20 14 23 23 23 14 20 20 20 20 20 20 20 14 20 20 20 23
23 20 15 20 20 20 20 20 20 20 20 20 20 14 14 14 20 20 20 20 20 20 24 24 14 20 20 14 20 20 20 20 14 23 00 00 00 23 14 20 20 20 20 20 20 20 20 20 15 23
23 20 15 15 20 20 20 20 20 20 20 20 14 23 23 23 14 20 20 20 20 20 20 24 20 20 20 20 20 20 20 20 14 23 00 16 00 23 14 20 20 20 20 20 20 20 20 20 15 23
23 20 20 15 20 20 20 20 20 20 20 14 23 00 00 00 23 14 20 20 20 20 24 24 20 20 20 20 20 20 20 20 14 23 00 00 00 23 14 20 20 20 14 20 20 20 20 20 15 23
23 20 20 20 15 20 20 20 20 20 20 14 23 00 16 00 23 14 20 18 20 14 24 24 20 20 20 20 20 20 20 20 20 14 23 23 23 14 20 20 20 20 20 20 20 20 20 20 20 23
23 20 15 15 20 20 18 20 20 20 20 14 23 00 00 00 23 14 20 20 20 20 24 24 20 20 20 20 20 14 20 20 20 20 14 14 14 20 20 20 20 20 20 20 20 20 20 20 20 23
23 20 15 15 20 20 20 20 20 20 20 20 14 23 23 23 14 20 20 20 20 20 24 24 20 20 20 20 20 20 20 20 20 20 20 20 20 20 20 20 20 20 20 20 20 20 20 18 20 23
23 20 20 20 20 20 20 20 20 20 20 20 20 14 14 14 20 20 20 20 20 20 24 24 20 20 20 18 20 20 20 20 20 20 20 20 20 20 20 14 20 20 14 20 20 20 20 20 20 23
23 20 20 20 20 20 20 20 20 20 15 20 20 20 20 20 20 20 20 20 20 20 24 24 20 20 20 20 20 20 20 20 14 20 20 20 20 20 20 20 20 20 20 20 20 18 20 20 20 23
23 20 20 20 20 20 20 20 20 20 20 20 20 20 20 20 20 20 20 20 18 20 24 14 20 20 20 20 20 20 20 20 20 20 20 20 20 14 20 20 20 20 20 20 20 20 20 20 20 23
23 15 15 14 14 14 14 15 15 15 20 20 20 20 20 20 20 20 20 20 20 20 24 24 20 20 20 20 20 20 18 20 20 20 20 20 20 20 20 20 15 15 15 14 14 14 14 15 15 23
23 15 14 21 21 21 21 14 15 15 20 20 15 20 20 20 20 20 20 20 14 20 24 24 20 20 20 20 20 20 20 20 20 20 20 20 20 20 20 20 15 15 14 21 21 21 21 14 15 23
23 14 21 21 28 28 21 21 14 15 20 20 20 20 20 20 14 20 20 20 20 20 24 24 20 20 20 20 20 20 20 20 20 18 20 20 20 20 20 20 15 14 21 21 26 26 21 21 14 23
23 21 21 21 22 22 21 21 21 14 20 20 20 20 20 20 20 20 20 20 20 20 24 24 20 20 20 20 20 20 20 20 20 20 20 20 20 20 20 20 14 21 21 21 22 22 21 21 21 23
23 21 27 22 22 22 22 29 21 14 20 20 20 20 20 20 20 20 20 18 20 20 20 24 14 20 20 20 18 20 20 20 20 20 20 20 20 18 20 20 14 21 27 22 22 22 22 29 21 23 
23 21 22 22 22 22 22 22 21 14 20 20 20 18 20 20 20 20 20 20 20 20 24 24 20 20 20 20 20 20 20 20 20 20 20 20 20 20 20 20 14 21 22 22 22 22 22 22 21 23 
23 21 22 22 22 22 22 22 21 14 20 20 20 20 20 20 20 20 20 20 20 20 20 24 20 20 20 20 20 20 20 20 20 20 20 20 20 20 20 20 14 21 22 22 22 22 22 22 21 23 
23 21 22 22 22 22 22 22 21 14 20 20 20 20 20 20 20 18 20 20 20 20 24 24 20 18 20 20 20 20 20 20 20 20 20 20 18 20 20 20 14 21 22 22 22 22 22 22 21 23
23 14 20 20 24 24 20 20 14 14 20 20 20 20 20 20 20 20 20 20 20 20 24 24 20 20 20 20 20 20 20 20 20 20 20 20 20 20 20 20 14 14 20 20 24 24 20 20 14 23
23 20 20 20 24 24 24 24 24 24 24 24 24 20 24 24 24 24 24 24 24 24 24 24 24 24 24 24 20 24 24 24 20 24 24 24 24 20 24 24 24 24 24 24 24 24 20 20 20 23
23 20 20 20 14 24 24 24 24 20 24 24 24 24 24 20 24 20 24 24 24 24 24 24 24 14 24 20 24 24 24 24 24 24 20 24 24 24 24 24 20 24 24 24 24 14 20 20 20 23 
23 14 20 20 20 20 20 20 20 20 20 20 20 20 20 20 20 20 20 20 20 20 24 24 20 20 20 20 20 20 20 20 20 20 20 20 20 20 20 20 20 20 20 20 20 20 20 20 15 23 
23 14 14 20 20 20 20 20 20 20 20 18 20 20 20 20 18 20 20 20 20 20 20 24 20 20 20 20 20 14 20 20 20 20 20 18 20 20 20 20 20 20 20 20 20 20 20 20 15 23
23 20 20 20 20 20 20 20 20 20 20 20 20 20 20 20 20 20 20 20 18 20 24 24 20 20 18 20 20 20 20 18 20 14 20 20 20 20 20 18 20 20 14 20 20 18 20 15 15 23
23 20 20 15 20 20 14 20 20 20 20 20 20 20 20 20 20 20 20 20 20 20 24 24 20 20 20 20 20 20 20 20 20 20 20 20 20 20 20 20 20 20 20 20 20 20 20 15 15 23
23 20 20 15 20 20 20 20 20 14 20 20 20 14 20 20 18 18 20 20 14 20 24 14 20 20 20 20 20 14 14 20 20 20 14 14 14 20 20 20 20 20 20 20 20 20 15 20 15 23
23 20 20 20 20 20 20 20 20 20 20 20 20 20 14 20 20 20 20 20 20 20 24 14 20 20 20 20 20 14 20 20 20 14 23 23 23 14 20 20 20 14 20 20 20 20 15 20 20 23
23 20 20 20 20 20 20 20 14 14 14 20 20 14 20 20 20 20 20 14 20 20 24 24 20 18 20 20 20 20 20 20 14 23 00 00 00 23 14 20 20 20 20 18 20 20 20 15 20 23
23 20 20 15 20 20 20 14 23 23 23 14 20 20 20 20 20 14 20 20 20 20 24 24 20 20 20 14 20 20 20 20 14 23 00 16 00 23 14 20 20 20 20 20 20 20 20 20 20 23
23 20 20 20 20 20 14 23 00 00 00 23 14 20 20 14 20 20 20 20 18 20 24 24 20 20 20 20 20 20 20 20 14 23 00 00 00 23 14 20 20 14 20 20 20 20 18 20 20 23
23 20 20 15 20 20 14 23 00 16 00 23 14 20 20 14 20 20 18 20 20 20 24 24 18 20 20 20 20 14 20 20 20 14 23 23 23 14 20 20 20 20 20 14 20 20 20 15 20 23
23 20 15 15 20 20 14 23 00 00 00 23 14 20 20 20 20 20 20 20 20 20 24 20 20 20 20 18 20 20 20 20 20 20 14 14 14 20 20 20 20 20 20 20 20 20 20 20 20 23
23 20 15 15 15 20 20 14 23 23 23 14 20 20 20 20 18 20 20 20 14 21 21 21 21 14 20 20 20 20 20 14 20 20 20 20 20 20 20 20 18 20 20 18 20 20 20 20 15 23
23 20 20 20 15 15 20 20 14 14 14 20 20 20 20 20 20 20 20 14 21 21 21 21 21 21 14 20 20 18 20 20 20 20 20 20 20 20 20 20 20 20 20 20 20 15 20 15 15 23
23 20 20 20 15 15 20 20 20 20 20 20 20 20 20 20 20 20 14 21 21 21 21 21 21 21 21 14 20 20 20 20 20 14 20 20 20 20 18 20 20 20 20 20 15 20 20 15 15 23
23 15 15 15 15 15 15 20 20 20 20 20 20 20 20 20 20 20 14 21 21 21 21 21 21 21 21 14 20 20 20 20 20 20 20 20 20 20 20 20 20 20 20 15 15 15 15 15 15 23
23 23 23 23 23 23 23 23 23 23 23 23 23 23 23 23 23 23 23 23 23 23 23 23 23 23 23 23 23 23 23 23 23 23 23 23 23 23 23 23 23 23 23 23 23 23 23 23 23 23